TILEMAP
36 8 			-- Size of tile map in tiles
16 32 			-- Tile size & block size
images/blocks.png 	-- Tilesheet
2 2 								-- Number of tiles in tilesheet
111111111111111111111111111111111111
11                                11
11                                11
11 4 3 2 1 4 3 2 1 4 3 2 1 4 3 2  11
11                                11
11  2 3 4 1 2 3 4 1 2 3 4 1 2 3 4 11
11                                11
111111111111111111111111111111111111