TILEMAP
120 10 			-- Size of tile map in tiles
64 64			-- Tile size
32 64 			-- Block size
images/TiledBoColor2.png 	-- Tilesheet
6 5 			-- Number of tiles in tilesheet
IIIIIIIIIIIIIIIIIIIIIIIIIIIIIIIIIIIIIIIIIIIIIIIIIIIIIIIIIIIIIIIIIIIIIIIIIIIIIIIIIIIIIIIIIIIIIIIIIIIIIIIIIIIIIIIIIIIIIIII
IIIOAABAAOJJJJJJJJJJJJJJJJJJJOAAAUJJJJJJJJJJJJJJJJJJJJJJJJJJJJJJJJJJJJJJJJJJJJJIOJJJJJJJJJJJJJJJJJJJJJJJAAAAAAAAUJJJJJJI
IIIIIIIIIOAAABABAAAAABABABABAOJJJZBAAABABAAABAABAAAAAABAAAAAABAUJJABAAAAAAAAVJAIOBAABAAABABAAABAAABABABAOANABABANUJJJJJI
IIIIIIIIIIOJNBABAZJJJJIIIIIIIOAAAZJJIIIIIIIIIIIIIIIIIIIIIIIIIIOZJJIOQJEBEBEBEQAIOJEIIIIIIIIIIIOAEAIIIIIIIIIIIIIIOZJJJJJI
IIIIIIIIIIOAEJJJJNAAAPJJFAAAAAAAANAAABBAAAAEJJAAAAAZJAABBAAABBANAAIIOBEBEBZJEAIIOSEJJBBANAANABABANAANAAAEJAANANBAEJJJJJI
IIIIIIIIIIIIOJJJJIIIIOJJIIIIIIIIIIIIIIIIIIIODDNAIOANDIIIIIIIIIIIIIIIIIOJEBEBAIIIIIOAAIIIIIIIIIIIIIIIIIIIOANAIIIIIOJJJJJI
IIIIIIIIIIIIOJJJJIIIIOAAIIIIIIIIIIIIIIIIIIIIIIIIIIIIIIIIIIIIIIIIIIIIIIOAJNAIIIIIIIIIIIIIIIIIIIIIIIIIIIIIIIIIIIIIIOPJJJJI
IIIIIIIIIIIIOJJJJIIIIIIIIIIIIIIIIIIIIIIIIIIIIIIIIIIIIIIIIIIIIIIIIIIOJAAAAAIIIIIIIIIIIIIIIIIIIIIIIIIIIIIIIIIIIIIIIIOJJJJI
IIIIIIIIIIIIOJJJJIIIIIIIIIIIIIIIIIIIIIIIIIIIIIIIIIIIIIIIIIIIIIIIIIIOAAIIIIIIIIIIIIIIIIIIIIIIIIIIIIIIIIIIIIIIIIIIIIOJJJJI
IIIIIIIIIIIIOAAAAIIIIIIIIIIIIIIIIIIIIIIIIIIIIIIIIIIIIIIIIIIIIIIIIIIIIIIIIIIIIIIIIIIIIIIIIIIIIIIIIIIIIIIIIIIIIIIIIIOAAAAI