TILEMAP
30 9 			-- Size of tile map in tiles
64 64			-- Tile size
32 64 			-- Block size
images/tiled1.png 	-- Tilesheet
6 3 			-- Number of tiles in tilesheet
000000000000000000000000000000
G00000000000C0000000000000G000
0000000000LLC0000000000000M000
0GA000IIIIIIG0L0L0G00000000000
00L00000A00000000000000000I000
000000000AA0000000000A00L0L000
G000000000L0A00C000B0BCD00AAA0
00000000000L000L00000000000000
000000000000000000000000000000

ABCDEF
GHIJKL
MN