TILEMAP
91 16 			-- Size of tile map in tiles
64 64			-- Tile size
32 64 			-- Block size
images/TiledBo.png 	-- Tilesheet
6 5 			-- Number of tiles in tilesheet
IIIIIIIIIIIIIIIIIIIIIIIIIIIIIIIIIIIIIIIIIIIIIIIIIIIIIIIIIIIIIIIIIIIIIIIIIIIIIIIIIIIIIIIIIII
IIIIIIIIIIIIIIIIIIIIIIIIIIIIIIIIIIIIIIIIIIIIIIIIIIIIIIIIIIIIIIIIIIIIIIIIIIIIIIIIIIIOBBAWJJI
IIIIIIIIIIIIIIIIIIIIIIIIIIIIIIIIIIIIIIIIIIIIIIIIIIIIIIIIIIIIIIIIIIIIIIIIIIIIIIIIIIIIIIOZKJI
IIIIIIIIIIIIIIIIIIIIIIIIIIIIIIIIIIIIIIIIIIIIIIIIIIIIIIIIIIIIIIIIIIIIIIIIIMNACABCANANAAANAAI
OKFCAACBBCACUJJJJNAAANBBCBBANPJKJJAACBCBCBBPJJJCACCABBACBBUKJAATKJTKJTJKBBANPKJJIIIIIIIIIII
OAZJIIIIIIOJNCBBAZKKJIIIIIIIIOJKJJJIIIIIIIIOJJJIIIIIIIIIIOZKJIIOKJOKJOJJIIIIOKJJIIIIIIIIIII
OJNDIIIIIIOJIIIIOEKKJIOZKJJIIOUKJJJIIIIIIIIOJKJIIIIOZKJIIOZKJIIOKJOKJOJJIIIIOKJJIIIIIIIIIII
OSNBACBANAOJIIIIIMKKJMJNAAANAAZKJJJIIIIIIIIOJKJIIIIOZKJNBAZJJIIOKJOKJOJJIIIIOKJJIIIIIIIIIII
IIOJJKJJIIMJNABBCNADANAZKKJIIOEKJJJIIIIIIIIMJKJIIIIOZKJIIOEJJIIMJJMJJMJJIMKJOKJJIIIIIIIIIII
IIOBAABANANDOJIIIIIIIOJNDDDIIIMDDDANAABANNANAADNBANNNDDIIIODDNANBDNBDNDDNNADODDDIIIIIIIIIII
IIIIIIIIIIIIOJIIIIIIIOJNAIIIIIIIIIIIIIIIIIIIIIIIIIIIIIIIIIIIIIIIIIIIIIIIIIIIIIIIIIIIIIIIIII
IIIIIIIIIIIIOJIIIIIIIOJIIIIIIIIIIIIIIIIIIIIIIIIIIIIIIIIIIIIIIIIIIIIIIIIIIIIIIIIIIIIIIIIIIII
IIIIIIIIIIIIOJIIIIIIIOJIIIIIIIIIIIIIIIIIIIIIIIIIIIIIIIIIIIIIIIIIIIIIIIIIIIIIIIIIIIIIIIIIIII
IIIIIIIIIIIIOJIIIIIIIOJIIIIIIIIIIIIIIIIIIIIIIIIIIIIIIIIIIIIIIIIIIIIIIIIIIIIIIIIIIIIIIIIIIII
IIIIIIIIIIIIOJIIIIIIIOJIIIIIIIIIIIIIIIIIIIIIIIIIIIIIIIIIIIIIIIIIIIIIIIIIIIIIIIIIIIIIIIIIIII
IIIIIIIIIIIIOAIIIIIIIOAIIIIIIIIIIIIIIIIIIIIIIIIIIIIIIIIIIIIIIIIIIIIIIIIIIIIIIIIIIIIIIIIIIII