TILEMAP
31 11 			-- Size of tile map in tiles
64 64			-- Tile size
32 64 			-- Block size
images/TiledBo.png 	-- Tilesheet
6 5 			-- Number of tiles in tilesheet
0000000000000000000000000000000
0000000000000000000000000000000
0000000000LL0000000000000000000
000000000000000L0L0000000000000
00L00000000000L0000000000000000
000000000000000000000000L0L0000
0000000000L000000000L000LL00000
00000000000L000L000000000000000
000L00L0L00L0L0L000L00000L00000
000L00L0L00L0L0L000L00L00L00000
0000000000000000000000000000000